openlogos

---
amarok = ?
apache = @
archlinux symbol = A
archlinux logo = B
blender = C
bsd = D
centos = E
copyleft = F
cc = G
creativecommon = H
cygwin = I
debian = J
edubuntu symbol = K
edubuntu logo = L
enlightenment = M
fedora symbol = N
fedora logo = O
firefox = P
gentoo = Q
gimp (wilber) = R
gnome = S
gnome (no text) = T
gnu = U
gtk = V
inkskape = W
joomla = X
kde = Y
knoppix = Z
kubuntu symbol = [
kubuntu logo =
kurumin = ]
linux = ^
lua = _
mandriva symbol = `
mandriva logo = a
mcn = b
mozilla = c
mysql = d
openclipart = e
openoffice = f
opensource = g
open suse = h
pardus = i
php = j
php mascot = k
postgresql = l
python = m
qt = n
redhat symbol = o
redhat logo = p
slackware = q
suse mascot = r
suse = s
tux = t
ubuntu symbol = u
ubuntu logo = v
wikimedia = w
wordpress = x
xfce = y
xorg = z
